0000000000000000000000000000000000000000000000000000000000000000000000000000000000000000000000000000-
1200000022000000002111111200211112000000000000002000000000002112000211111200000000000000000000002221-
1200000000000000002211111200211112200000000000000000000000002112000211111220000000000000000000000022-
1202220000000000000211111200211111200000000000000000000000002112000211111120020000000000000000000002-
1222122000000000000211111200211111200000000000000000000000002112000211111122222200000000000000000002-
1111120000000000002211111200211111200000000000000000000000002112000211111120211222000000000000000022-
1111120000000000002111111200211111200000000000000000000000002112000211111120211120000000000000000002-
1111120000000000022111111200211111200000000000000000022222222112000211111120211120000000000000000002-
1222120000000000021111222200222211200000000000000000221111122222000211111120211120000000000000000002-
1202120000000022221222200000220211200000000200000000021111120002000211111122211120000000000000000002-
1222120000000222222200000000202211200000000000000000222221120002000211111120211220000000000000000002-
1111120000000002202000000000000211200000000000000000022022220002000211111120212200000000000000000022-
1111120000000222200000000000000211200000000000022220000020020002000222222120212000000000000000000002-
1111120000002222000000000000000211220000000000221120000000000002200022002220212220000000000000000022-
1111120000002220000000000000000211120000000000211120000000000002200000000220221120000000000000000002-
1111120000002200000000000000000211120000000000211120000000000000220000000000021120000000000000000000-
1111120000000000000000000000000211120000000000211120000000000000222200000000221120000000000000000002-
1111120000000000000000000000000211220000000000211120000000000002222000000000021220000000000000000022-
1111120000000000000000000000000211200000000000211220000000000002120000000000221200000000000002222221-
1111120000000000000000000000000212200000000000211200000000000202122000000000021200000000000002111111-
1111120000000000000000000000000222000000000000212200000000002222112000002222221200000000000002111111-
1111120000000000000000000000000220000000000002212000000022022111112200000021111200000000000002111111-
1111120000000000000000000000000220000000000022112000000022221111111200000221111200000000000002111111-
1111120000000000000000000000000220000000000002112000000021111111112200000211111200000000000002111111-
1111222000000000000000000000000220000000000002112000000021111111112000000222222200000000000002111111-
1111200000000000000000020000000200002220000022112200000021111111112000000000000200000000000022111111-
1111200000000000000000020000002200002120000021112200000021111111112000000000000200000000000021111111-
1111220000002222222222200000002200222122000021112020000021111111112200000000000000000000000021111111-
1222222000002222222222200000002220022222000021122200000022222222112200000000000200000000000021111111-
1202200000000000000000000000022120000000000021120000000002200002122000000000000200000000000021111111-
1222200000000000000000000000022120000000000021122000000002000002120000000000000000000000000021111111-
1111222000000000000000000000002120000000000022120000000000000002122000000000000000000000000021111111-
1222122000000000000000000000002120000000000002222000000000002222112000000000000000000000000021111111-
1202220000000000000000000000222120000000000000212000000000022111122000000000000200000000000021111111-
1220020000000000200000000000211120000000000000212000000022221111120002000000000200000000222021111111-
1122222222222222220022200002211120000200002222212000220022111112220002200022222202220000212221111111-
0000000000001111200022220022111120002220002111112200222002111112000002202221111222122000211111111111-
1111111111111111200000200002111122002120022111111200212022111112000022200211111111112000221111111111-
1111111111111111222200020002111112222120022111111222212002111112220221200221111111112000021111111111-
1111111111111111111200200002222222122220002221111111222002221222222211200022211111122000022222222211-
1111111111111112222200000000220002220000000022222222200002022200200222200000222222220000000022020222-
1111111111111112000000000000000000000000000000000000000000000000000000000000000000000000000000000220-
1111111111111112000000000000000000000000000000000000000000000000000000000000000000000000000000000000-
1111111111111112000000000000000000000000000000000000000000000000000000000000000000000000000000000220-
1111111111111112000000000000000000000000000000000000000000000000000000000000000000000000000000000220-
1111111111111112000000000000000000000000000000000000000000000000000000000000000000000000000000000220-
1111111111111122200000000000000000000000000000000000000000000000000000000000000000000000000000000220-
1111111111111220000000000000000000000000000000000000000000000000000000000000000000000000000000000022-
1111111111111200000000000000000000000000000000000000000000000000000000000000000000000000000000000222-
1111111111112200000000000000000000000000000000000000000000000000000000000000000000000000000000000000-
1111111111112000000000000000000000000000000000000000000000000000000000000000000000000000000000000000-
1111111111112200000000000000000000000000000000000000000000000000000000000000000000000000000000000000-
1111111111111222000000000000000000000000000000000000000000000000000000000000000000000000000000000000-
1111111111111120000000000000000000000000000000000000000000000000000000000000000000000000000000000000-
1111111111111122000000000000000000000000000000000000000000000000000000000000000000000000000000000222-
1111111111111112000000020000000000000000000000000000000000000000000000000000000200000000000000002220-
1111111111111112200002200022222222002222000222222200222000002222000220000000222200000000222222202220-
1111112221111111220002200021111122002122000211112000212000002112200222000000211200000000211111200000-
1111122021111111220022220022111120002120000211112202222000022112000000000000211200000000211111200000-
1222220022222222200022200202211120002220000222222200220000002222000220000000211220000000211111200000-
1200000000000000000000000000211122222200000000002200000000000022000220000000211120000000211111200000-
1200000000000000000000000002222211111200000000000000000000000000000220000000211120000000212221200000-
1200000000000000000000000002220222222200000000002222200000000002000220000000211120000000222022200000-
1200000000000000000000000000000220000000000000002111200000000002000220000000211120000000000000000000-
1200000000000000000000000000000220000000000000002111220000000000000220000000211120000000000002200000-
1200002222222222222222222200000220000000000000002112200000000002000020000000211122000000000022200000-
1200000211111111111111112200000220000000000000002112000000000002000020000000211112000000000002200000-
1200000211111112221111112000000220000000000000002112000000000002000000000000211112000000000022200000-
2200000221111112021111112000000220000000000000002112200000000000000000000000211222000000000002000000-
0000000022222222022221122000000220000000000020222111222000000002002200000000211200022222222000000000-
2220000000000020000022220000000000000000000022211111112000000002222220000000212200221111112200000000-
1120000000000000000002020000000020000000000021111111112000000002111120000000212000221111111200000000-
1220000000000000000000022000000022000000000021111111112000000002111120000000212000022221111200000000-
1200000002220000000000022000000022200000000221111111112002222222111220000000212000020021111200000000-
1200000022120000000000020000000021200000002222222122222002211112222200000000212000000021111200000000-
1200000021120000000000020000000021200000000202202120000020222212000200000000212000000021111200000000-
1200000021120000000000022000000021200000000000002220000000220212000000000000222000000021111200000000-
1200000021120000000000022000000021222000000000222200000000000212000000000000000000000021111200000000-
1200000022220000000000022000000021112200000000212000000000000212000000000000000000000021111200000000-
1200000000220000000000020000000021122200000000212200000000002222000000000000000000000021111200000000-
1200000022220000000000000000000022220000000000211200000002022120000000000000000000000021111200000000-
1200000002000000000000200000000020000000022000211220222222221120000000000000000200000021111200000000-
1200000000000000000000020000000020000200022200221120211111111120000000000000000200000021111200000000-
1200000000000000000000220000000020002222221200021120211111122220000000000000000200000021111200000000-
1220000000000000000000200000000020002111111220022220211111120000000000000000000200000021111200000000-
1200000000000000000000220000022000002111111120002000211111120000000000000022000000000021111200000000-
1200000000002222222222220000000020002111111122002200211111120000000000222222000200000221111200000000-
1200000000002222222222220000000020002112221122202200211111120000000000211112000200000211111200000000-
1200000000000000000000000000000020002112021120002002211111120000000002211112000200000222222200000000-
1200000000000000000000000000002220002112021122202200212221120002000002111112000200000000000000000000-
1200000000000000000000000000022220002112021112002022212021120002000002111112000222222222222200000000-
1200000000000000000000000000020220022112021112002021112021120002000002111112000211111111111200000000-
1200000000000000000000000000002220002212021112002221112021120002000002111112000211111111111200000000-
1200000000000000000000000000002122200212221112222111112021120002000022111112002211111111111200000000-
1200222222222222222222222222222111222211111111111111112221122222222221111112222111111111111222200000-
1222211111111111111111111111111111111111111111111111111111111111111111111111111111111111111111200000-
1111111111111111111111111111111111111111111111111111111111111111111111111111111111111111111111200000-
--