2222222222222222222222222222222222222222222222000000000000000022222222222222222222222222222222222222222-
2222222222222222222222222222222222222222222222000000000000000022222222222222222222222222222222222222222-
2120000000000000000000000000000000000000000000000000000000000000000002111111111111111111112200000000021-
2120000000000000000000000000000000000000000000000000000000000000000022111111111111111111111200000000021-
2120000000000000000000000000000000000000000000000000000000000000000221111111111111111111111220000000021-
2120000000000000000000000000000000000000000000000000000000000000000211111111111111111111111120000000021-
2120002222000000000000000000000000000000000000000000000000000000000211111111111111111111111120000000021-
2120002112000000000000000000000000002222200000000000000000000000000211111111111111111111111120000000021-
2120002112000000000000000000000000002112200000000000000000000000000211111111111111111111111120000000021-
2122222112000000000000000000000000002222200000000000000000000000000211111111111111111111111120000000021-
2122222222000000000000000000000000000000000000000000000000000000000221111111111111111111111120000000021-
2120000000000000000000000000000000000000000000000000000000000000000022111111111111111111111220000000021-
2120000000000000000000000000000000000000000000000000000000000000000002111111111111111111112200000000021-
2120000000000000000000000000000000000000000000000000000000000000000002111111111111111111122000000000021-
2120000000000000000000000000000000000000000000000000000000000000000002211111111111111111220000000000021-
2120000000000000000000000000000000000000000000000000000000000000000000222111111111111112200000000000021-
2120000000000000000000000000000000000000000000000000000000000000000000002211111111111222000000000000021-
2120000000000000000000000000000000000000000000000000000000000000000000000222111111112200000000000000021-
2120000000000000000000000000000000000000000000000000000000000000000000000002222222222000000000000000021-
2120000000000000000000000000000000000000000000000000000000000000000000000000000000000000000000000000021-
2120000000002200000000000000000000000000000000000000000000000000000000000000000000000000000000000000021-
2120000000002200000000000000000000000000000000000000000000000000000000000000000000000000000000000000021-
2120000000002200000000000000000000000000000000000000000000000000000000000000000000000000000000000000021-
2120000000002200000000000000000000000000000000000000000000000000000000000000000000000000000000000000021-
2122222222222200000000000000000000000000000000000000000000000000000000000000000000000000000000000000021-
2120000000000000000000000000000000000000000000000000000000000000000000000000000000000000000000000000021-
2120000000000000000000000000000000000000000000000000000000000000000000000000000000000000000000000000021-
2120000000000000000000000000000000000000000000000000000000000000000000000000000000000000000000000000021-
2122222222222200000000000000000000000000000000000000000000000000000000000000000000000000000000000000021-
2120000000000000000000000000000000000000000000000000000000000000000000000222222222222222222222200000021-
2120000000000000000000000000000000000000000000000000000000000000000000000211111111111111111111200000021-
2120000000000000000000000000000000000000000000000000000000000000000000000211111111111111111111200000021-
2120000000000000000000000000000000000002220000000000000000000000000000000211111111111111111111200000021-
2120000000000022222222000000000000000002120000000000000000000000000000000211111111111111111111200000021-
2120000002222221111111222000000000000002120000000000000000000000000000000211111111111111111111200000021-
2120000002211111111111111200000000000002120000000000000000000000000000000211111111111111111111200000021-
2120000021111111111111112200000000000002120000000000000000000000000000000211111111111111111111200000021-
2120000221111111111111111200000000000002120000000000000000000000000000000211111111111111111111200000021-
2120000211111111111111111200000000000002220000000000000000000000000000000211111111111111111111200000021-
2120000221111111111111111200000000000000000000000000000000000000000000000211111111111111111111200000021-
2120000021111111111111112200000000000000000000000000000000000000000000000211111111111111111111200000021-
2120000022221111111112222000000000000000000000000000000000000000000000000211111111111111111111200000021-
2120000000022221111222000000000000000000000000000000000000000000000000000222222222222222222222200000021-
2120000000000022222200000000000000000000000000000000000000000000000000000000000000000000000000000000021-
2120000000000000000000000000000000000000000000000000000000000000000000000000000000000000000000000000021-
2120000000000000000000000000000000000000000000000000000000000000000000000000000000000000000000000000021-
2120000000000000000000000000000000000000000000000000000000000000000000000000000000000000000000000000021-
2120000000000000000000000000000000000000000000000000000000000000000000000000000000000000000000000000021-
2120000000000002200000000000000000000000000000000000000000000000000000000000000000000000000000000000021-
2120000000000002200000000000000000000000000000000000000000000000000000000000000000000000000000000000021-
2120000000000002200000000000000000000000000000000000000000000000000000000000000000000000000000000000021-
2122222222222222200000000000000000000000000000000000000000000000000000000222222222222222222222200000021-
2122222222222222200000000000000000000000000000000000000000000000000000000211111111111111111111200000021-
2120000000000000000000000000000000000000000000000000000000000000000000000211111111111111111111200000021-
2120000000000000000000000000000000000000000000000000000000000000000000000211111111111111111111200000021-
2120000000000022222222000000000000000000000000000000000000000000000000000211111111111111111111200000021-
2120000002222221111111222000000000000000000000000000000000000000000000000211111111111111111111200000021-
2120000002211111111111111200000000000000000000000000000000000000000000000211111111111111111111200000021-
2120000021111111111111112200000000000000000000000000000000000000000000000211111111111111111111200000021-
2120000221111111111111111200000000000000000000000000000000000000000000000211111111111111111111200000021-
2120000211111111111111111200000000000000000000000000000000000000000000000211111111111111111111200000021-
2120000221111111111111111200000000000000000000000000000000000000000000000211111111111111111111200000021-
2120000021111111111111112200000000000000000000000000000000000000000000000211111111111111111111200000021-
2120000022221111111112222000000000000000000000000000000000000000000000000211111111111111111111200000021-
2120000000022221111222000000000000000000000000000000000000000000000000000222222222222222222222200000021-
2120000000000022222200000000000000000000000000000000000000000000000000000000000000000000000000000000021-
2120000000000000000000000000000000000000000000000000000000000000000000000000000000000000000000000000021-
2120000000000000000000000000000000000000000000000000000000000000000000000000000000000000000000000000021-
2120000000000000000000000000000000000000000000000000000000000000000000000000000000000000000000000000021-
2120000000000000000000000000000000000000000000000000000000000000000000000000000000000000000000000000021-
2120000000000000000000000000000000000000000000000000000000000000000000000000000000000000000000000000021-
2120000000000000000000000000000000000000000000000000000000000000000000000000000000000000000000000000021-
2120000000000000000000000000000000000000000000000000000000000000000000000000000000000000000000000000021-
2120000000000000000000000000000000000000000000000000000000000000000000000222222222222222222222200000021-
2120000000000000000000000000000000000000000000000000000000000000000000000211111111111111111111200000021-
2120000000000000000000000000000000000000000000000000000000000000000000000211111111111111111111200000021-
2120000000000000000000000000000000000000000000000000000000000000000000000211111111111111111111200000021-
2120000000000022222222000000000000000000000000000000000000000000000000000211111111111111111111200000021-
2120000002222221111111222000000000000000000000000000000000000000000000000211111111111111111111200000021-
2120000002211111111111111200000000000000000000000000000000000000000000000211111111111111111111200000021-
2120000021111111111111112200000000000000000000000000000000000000000000000211111111111111111111200000021-
2120000221111111111111111200000000000000000000000000000000000000000000000211111111111111111111200000021-
2120000211111111111111111200000000000000000000000000000000000000000000000211111111111111111111200000021-
2120000221111111111111111200000000000000000000000000000000000000000000000211111111111111111111200000021-
2120000021111111111111112200000000000000000000000000000000000000000000000211111111111111111111200000021-
2120000022221111111112222000000000000000000000000000000000000000000000000211111111111111111111200000021-
2120000000022221111222000000000000000000000000000000000000000000000000000222222222222222222222200000021-
2120000000000022222200000000000000000000000000000000000000000000000000000000000000000000000000000000021-
2120000000000000000000000000000000000000000000000000000000000000000000000000000000000000000000000000021-
2120000000000000000000000000000000000000000000000000000000000000000000000000000000000000000000000000021-
2120000000000000000000000000000000000000000000000000000000000000000000000000000000000000000000000000021-
2120000000000000000000000000000000000000000000000000000000000000000000000000000000000000000000000000021-
2120000000000000000000000000000000000000000000000000000000000000000000000000000000000000000000000000021-
2120000000000000000000000000000000000000000000000000000000000000000000000000000000000000000000000000021-
2120000000000000000000000000000000000000000000000000000000000000000000000000000000000000000000000000021-
2120000000000000000000000000000000000000000000000000000000000000000000000000000000000000000000000000021-
2120000000000000000022000000000000000000000000000000000000000000000000000000000000000000000000000000021-
2120000000000000000022000000000000000000000000000000000000000000000000000000000000000000000000000000021-
2120000000000000000022000000000000000000000000000000000000000000000000000000000000000000000000000000021-
2120000000000000000022000000000000000000000000000000000000000000000000000000000000000000000000000000021-
2120000000000000000022222220000000000000000000000000000000000000000000000000000000000000000000000000021-
2120000000000000000022222220000000000000000000000000000000000000000000000000000000000000000000000000021-
2120000000000000000000000000000000000000000000000000000000000000000000000002222222222000000000000000021-
2120000000000000000000000000000000000000000000000000000000000000000000000222111111112200000000000000021-
2120000000000000000000000000000000000000000000000000000000000000000000002211111111111222000000000000021-
2120000000000000000000000000000000000000000000000000000000000000000000022111111111111112200000000000021-
2120000000000000000000000000000000000000000000000000000000000000000002221111111111111111220000000000021-
2120000000000000000000000000000000000000000000000000000000000000000002111111111111111111122000000000021-
2120000000000000000000000000000000000000000000000000000000000000000002111111111111111111112200000000021-
2120000000000000000000000000000000000000000000000000000000000000000022111111111111111111111200000000021-
2222222222222222222222222222222222222222222222222222222222222222222222222222222222222222222222222222222-
2222222222222222222222222222222222222222222222222222222222222222222222222222222222222222222222222222222-
--