22222222222222222222222222222222222222222222222222222222222222222222222222222222222222222222-
21111111111111111111111111111111111111111111111111111111111111111111111111111111111111111112-
21222222222222222222222222222222222222222222222222222222222222222222222222222222222222222212-
21200000211112000000000021111200000000000000000000000000212000000000000000000000000000000212-
21200000211112000000000021111200000000000000000000000000212000000000000000000000000000000212-
21200000211112000000000021111200000000000000000000000000212000000000000000000000000000000212-
21200000211112000000000021111200000000000000000000000000212000000000000000000000000000000212-
21200000211112000000000021111200000000000000000000000000212000000000000000000000000000000212-
21200000211112000000000021111200000000000000000000000000212000000000000000000000000000000212-
21200000211112000000000021111200000000000000000000000000212000000000000000000000000000000212-
21200000211112000000000021111200000000000000000000000000212000000000000000000000000000000212-
21200000211112000000000021111200000000000000000000000000212000000000000000000000000000000212-
21200000211112000000000021111200000000000000000000000000212000000000000000000000000000000212-
21200000222222000000000022222200000000000000000000000000222000000000000000000000000000000212-
21200000000000000000000000000000000000000000000000000000000000000000000000000000000000000212-
21200000000000000000000000000000000000000000000000000000000000000000000000000000000000000212-
21200000000000000000000000000000000000000000000000000000000000000000000000000000000000000212-
21200000000000000000000000000000000000000000000000000000000000000000000000000000000000000212-
21200000000000000000000000000000000000000000000000000000000000000000000000000000000000000212-
21200000000000000000000000000000000000000000000000000000000000000000000000000000000000000212-
21200000000000000000000000000000000000000000000000000000000000000000000000000000000000000212-
21200000000000000000000000000000000000000000000000000000000000000000000000000000000000000212-
21200000000000000000000000000000000000000000000000000000000000000000000000000000000000000212-
21200000000000000000000000000000000000000000000000000000000000000000000000000000000000000212-
21200000000000000000000000000000000000000000000000000000000000000000000000000000000000000212-
21200000000000000000000000000000000000000000000000000000000000000000000000000000000000000212-
21200000000000000000000000000000000000000000000000000000000000000000000000000000000000000212-
21200000000000000000000000000000000000000000000000000000000000000000000000000000000000000212-
21200000000000000000000000000222000000000000000000000000000000000000222000000000000000000212-
21200000000000000000000000000212000000000000000000000000000000000000212000000000000000000212-
21200000000000000000000000000212000000000000000000000000000000000000212000000000000000000212-
21200000000000000000000000000212000000000000000000000000000000000000212000000000000000000212-
21200000000000000000000000000212000000000000000000000000000000000000212000000000000000000212-
21222222222222222222222222222222000000000000000000000000000000000000222222222222222222222212-
21111111111111111111111111111112000000000000000000000000000000000000211111111111111111111112-
21222222222222222222222222222222000000000000000000000000000000000000222222222222222222222212-
21200000000000000000000000000212000000000000000000000000000000000000212000000000000000000212-
21200000000000000000000000000212000000000000000000000000000000000000212000000000000000000212-
21200000000000000000000000000212000000000000000000000000000000000000212000000000000000000212-
21200000000000000000000000000212000000000000000000000000000000000000212000000000000000000212-
21200000000000000000000000000222000000000000000000000000000000000000222000000000000000000212-
21200000000000000000000000000000000000000000000000000000000000000000000000000000000000000212-
21200000000000000000000000000000000000000000000000000000000000000000000000000000000000000212-
21200000000000000000000000000000000000000000000000000000000000000000000000000000000000000212-
21200000000000000000000000000000000000000000000000000000000000000000000000000000000000000212-
21200000000000000000000000000000000000000000000000000000000000000000000000000000000000000212-
21200000000000000000000000000000000000000000000000000000000000000000000000000000000000000212-
21200000000000000000000000000000000000000000000000000000000000000000000000000000000000000212-
21200000000000000000000000000000000000000000000000000000000000000000000000000000000000000212-
21200000000000000000000000000000000000000000000000000000000000000000000000222000000000000212-
21200000000000000000000000000000000000000000000000000000000000000000000000212000000000000212-
21200000000000000000000000000000000000000000000000000000000000000000000000212000000000000212-
21200000000000000000000000000000000000000000000000000000000000000000000000212000000000000212-
21200000000000000000000000000000000000000000000000000000000000000000000000222000000000000212-
21200000000000000000000000000222000000000000000000000000000000000000222000000000000000000212-
21200000000000000000000000000212000000000000000000000000000000000000212000000000000000000212-
21200000000000000000000000000212000000000000000000000000000000000000212000000000000000000212-
21200000000000000000000000000212000000000000000000000000000000000000212000000000000000000212-
21200000000000000000000000000212000000000000000000000000000000000000212000000000000000000212-
21222222222222222222222222222222000000000000000000000000000000000000222222222222222222222212-
21111111111111111111111111111112000000000000000000000000000000000000211111111111111111111112-
21222222222222222222222222222222000000000000000000000000000000000000222222222222222222222212-
21200000000000000000000000000212000000000000000000000000000000000000212000000000000000000212-
21200000000000000000000000000212000000000000000000000000000000000000212000000000000000000212-
21200000000000000000000000000212000000000000000000000000000000000000212000000000000000000212-
21200000000000000000000000000212000000000000000000000000000000000000212000000000000000000212-
21200000000000000000000000000222000000000000000000000000000000000000222000000000000000000212-
21200000000000000000000000000000000000000000000000000000000000000000000000000000000000000212-
21200000000000000000000000000000000000000000000000000000000000000000000000000000000000000212-
21200000000000000000000000000000000000000000000000000000000000000000000000000000000000000212-
21200000000000000000000000000000000000000000000000000000000000000000000000000000000000000212-
21200000000000000000000000000000000000000000000000000000000000000000000000000000000000000212-
21200000000000000000000000000000000000000000000000000000000000000000000000000000000000000212-
21200000000000000000000000000000000000000000000000000000000000000000000000222000000000000212-
21200000000000000000000000000000000000000000000000000000000000000000000000212000000000000212-
21200000000000000000000000000000000000000000000000000000000000000000000000212000000000000212-
21200000000000000000000000000000000000000000000000000000000000000000000000212000000000000212-
21200000000000000000000000000000000000000000000000000000000000000000000000222000000000000212-
21200000000000000000000000000222000000000000000000000000000000000000222000000000000000000212-
21200000000000000000000000000212000000000000000000000000000000000000212000000000000000000212-
21200000000000000000000000000212000000000000000000000000000000000000212000000000000000000212-
21200000000000000000000000000212000000000000000000000000000000000000212000000000000000000212-
21200000000000000000000000000212000000000000000000000000000000000000212000000000000000000212-
21222222222222222222222222222222000000000000000000000000000000000000222222222222222222222212-
21111111111111111111111111111112000000000000000000000000000000000000211111111111111111111112-
21222222222222222222222222222222000000000000000000000000000000000000222222222222222222222212-
21200000000000000000000000000212000000000000000000000000000000000000212000000000000000000212-
21200000000000000000000000000212000000000000000000000000000000000000212000000000000000000212-
21200000000000000000000000000212000000000000000000000000000000000000212000000000000000000212-
21200000000000000000000000000212000000000000000000000000000000000000212000000000000000000212-
21200000000000000000000000000222000000000000000000000000000000000000222000000000000000000212-
21200000000000000000000000000000000000000000000000000000000000000000000000000000000000000212-
21200000000000000000000000000000000000000000000000000000000000000000000000000000000000000212-
21200000000000000000000000000000000000000000000000000000000000000000000000000000000000000212-
21200000000000000000000000000000000000000000000000000000000000000000000000000000000000000212-
21200000000000000000000000000000000000000000000000000000000000000000000000000000000000000212-
21200000000000000000000000000000000000000000000000000000000000000000000000000000000000000212-
21200000000000000000000000000000000000000000000000000000000000000000000000000000000000000212-
21200000000000000000000000000000000000000000000000000000000000000000000000000000000000000212-
21200000000000000000000000000000000000000022220000000000000000000000000000000000000000000212-
21200000000000000000000000000222000000000021120000000000000000000000222000000000000000000212-
21200000000000000000000000000212000000000021120000000000000000000000212000000000000000000212-
21200000000000000000000000000212000000000021120000000000000000000000212000000000000000000212-
21200000000000000000000000000212000000000022220000000000000000000000212000000000000000000212-
21200000000000000000000000000212000000000000000000000000000000000000212000000000000000000212-
21222222222222222222222222222222222222222222222222222222222222222222222222222222222222222212-
21111111111111111111111111111111111111111111111111111111111111111111111111111111111111111112-
22222222222222222222222222222222222222222222222222222222222222222222222222222222222222222222-
--


