0000000000000000000000000000000000000000000000000000000000000000000000000000000000000000000000000000-
0000000000000000000000000000000000000000000000000000000000000000000000000000000000000000000000000000-
0000000000000000000000000000000000000000000000000000000000000000000000000000000000000000000000000000-
0000000000000000000000000000000000000000000000000000000000000000000000000000000000000000000000000000-
0000000000000000000000000000000000000000000000000000000000000000000000000000000000000000000000000000-
0000000000000000000000000000000000000000000000000000000000000000000000000000000000000000000000000000-
0000000000000000000000000000000000000000000000000000000000000000000000000000000000000000000000000000-
0000000000000000000000000000000000000000000000000000000000000000000000000000000000000000000000000000-
0000000000000000000000000000000000000000000000000000000000000000000000000000000000000000000000000000-
0000000000000000000000000000000000000000000000000000000000000000000000000000000000000000000000000000-
0000000000000000000000000000000000000000000000000000000000000000000000000000000000000000000000000000-
0000000000000000000000000000000000000000000000000000000000000000000000000000000000000000000000000000-
0000000000000000000000000000000000000000000000000000000000000000000000002222222222222222200000000000-
0000000000000000000000000000000000000000000000000000000000000000000000002111111111111111200000000000-
0000000000000000000000000000022222222222222222222220000000000000000000002111111111111111200000000000-
0000000000000000000000000000021111111111111111111120000000000000000000002111111111111111200000000000-
0000000000000222222220000000021111111111111111111120000000000000000000002111111111111111200000000000-
0000000022222211111112220000021111111111111111111120000000000000000000002111111111111111200000000000-
0000000221111111111111120000021111111111111111111120000000000000000000002111111111111111200000000000-
0000000211111111111111122000021111111111111111111120000000000000000000002111111111111111200000000000-
0000002211111111111111112000021111111111111111111120000000000000000000002111111111111111200000000000-
0000002111111111111111112000021111111111111111111120000000000000000000002111111111111111200000000000-
0000002211111111111111112000021111111111111111111120000000000000000000002111111111111111200000000000-
0000000211111111111111122000021111111111111111111120000000000000000000002111111111111111200000000000-
0000000222211111111122220000022222222222222222222220000000000000000000002111111111111111200000000000-
0000000000222211112220000000000000000000000000000000000000000000000000002222222222222222200000000000-
0000000000000222222000000000000000000000000000000000000000000000000000000000000000000000000000000000-
0000000000000000000000000000000000000000000000000000000000000000000000000000000000000000000000000000-
0000000000000000000000000000000000000000000000000000000000000000000000000000000000000000000000000000-
0000000000000000000000000000000000000000000000000000000000000000000000000000000000000000000000000000-
0000000000000000000000000000000000000000000000000000000000000000000000000000000000000000000000000000-
0000000000000000000000000000000000000000000000000000000000000000000000000000000000000000000000000000-
0000000000000000000000000000000000000000000000000000000000000000000000000000000000000000000000000000-
0000000000000000000000000000000000000000000000000000000000000000000000000000000000000000000000000000-
0000000000000000000000000000000000000000000000000000000000000000000000000000000000000000000000000000-
0000000000000000000000000000000000000000000000000000000000000000000000000000000000000000000000000000-
0000000000000000000000000000000000000000000000000000000000222222222222222222222222220000000000000000-
0000000000000000000000000000000000000000000000000000000000211111111111111111111111120000000000000000-
0000000000000000000000000000000000000000000000000000000000211111111111111111111111120000000000000000-
0000000222222222222222222222222222220000000000000000000000211111111111111111111111120000000000000000-
0000000211111111111111111111111111120000000000000000000000211111111111111111111111120000000000000000-
0000000211111111111111111111111111120000000000000000000000211111111111111111111111120000000000000000-
0000000211111111111111111111111111120000000000000000000000211111111111111111111111120000000000000000-
0000000211111111111111111111111111120000000000000000000000211111111111111111111111120000000000000000-
0000000211111111111111111111111111120000000000000000000000211111111111111111111111120000000000000000-
0000000211111111111111111111111111120000000000000000000000211111111111111111111111120000000000000000-
0000000211111111111111111111111111120000000000000000000000211111111111111111111111120000000000000000-
0000000211111111111111111111111111120000000000000000000000211111111111111111111111120000000000000000-
0000000211111111111111111111111111120000000000000000000000211111111111111111111111120000000000000000-
0000000211111111111111111111111111120000000000000000000000211111111111111111111111120000000000000000-
0000000211111111111111111111111111120000000000000000000000211111111111111111111111120000000000000000-
0000000211111111111111111111111111120000000000000000000000211111111111111111111111120000000000000000-
0000000211111111111111111111111111120000000000000000000000211111111111111111111111120000000000000000-
0000000211111111111111111111111111120000000000000000000000211111111111111111111111120000000000000000-
0000000211111111111111111111111111120000000000000000000000211111111111111111111111120000000000000000-
000000021111111111111111111111111112000000000000000000000021111111111111111111111112000000000000000000000002111111111111111111111111111200000000000000000000-
0000000222222222222222222222222222220000000000000000000000211111111111111111111111120000000000000000-
0000000000000000000000000000000000000000000000000000000000211111111111111111111111120000000000000000-
0000000000000000000000000000000000000000000000000000000000222222222222222222222222220000000000000000-
0000000000000000000000000000000000000000000000000000000000000000000000000000000000000000000000000000-
0000000000000000000000000000000000000000000000000000000000000000000000000000000000000000000000000000-
0000000000000000000000000000000000000000000000000000000000000000000000000000000000000000000000000000-
0000000000000000000000000000000000000000000000000000000000000000000000000000000000000000000000000000-
0000000000000000000000000000000000000000000000000000000000000000000000000000000000000000000000000000-
0000000000000000222222222222222222222222222200000000000000000000000000000000000000000000000000000000-
0000000022222222211111111111111111111111111222222222000000000000000000000000000000000000000000000000-
0000000021111111111111111111111111111111111111111112000000000000000000000000000000000000000000000000-
0000000022111111111111111111111111111111111111111122000000000000000000000000000000000000000000000000-
0000000002222222222222222222222222222222222222222220000000000000000000000000000000000000000000000000-
0000000000000000000000000000000000000000000000000000000000000000000000000022222222220000000000000000-
0000000000000000000000000000000000000000000000000000000000000000000000002221111111122000000000000000-
0000000000000000000000000000000000000000000000000000000000000000000000022111111111112220000000000000-
0000000000000000000000000000000000000000000000000000000000000000000000221111111111111122000000000000-
0000000000000000000000000000000000000000000000000000000000000000000022111111111111111112200000000000-
0000000000000000000000000000000000000000000000000000000000000000000211111111111111111111220000000000-
0000000000000000000000000000000000000000000000000000000000000000022111111111111111111111122000000000-
0000000000000000000000000000000000000000000000000000000000000000022111111111111111111111112000000000-
0000000000000000000000000000000000000000000000000000000000000000022111111111111111111111112200000000-
0000000000000000000000000000000000000000000000000000000000000000022111111111111111111111112200000000-
0000000000000000000000000000000000000000000000000000000000000000022111111111111111111111112200000000-
0000000000000000000000000000000000000000000000000000000000000000022111111111111111111111112200000000-
0000000000000000000002222222222222222222222222222222222222000000022111111111111111111111112200000000-
0000000000000000000002111111111111111111111111111111111112000000022111111111111111111111112200000000-
0000000000000000000002111111111111111111111111111111111112000000022111111111111111111111112200000000-
0000000000000000000002111111111111111111111111111111111112000000022111111111111111111111112200000000-
0000000000000000000002111111111111111111111111111111111112000000022111111111111111111111112200000000-
0000000000000000000002111111111111111111111111111111111112000000022111111111111111111111112200000000-
0000000000000000000002111111111111111111111111111111111112000000002211111111111111111111112200000000-
0000000000000000000002111111111111111111111111111111111112000000000221111111111111111111112200000000-
0000000000000000000002111111111111111111111111111111111112000000000021111111111111111111122000000000-
0000000000000000000002111111111111111111111111111111111112000000000021111111111111111111220000000000-
0000000000000000000002111111111111111111111111111111111112000000000022111111111111111112200000000000-
0000000000000000000002222222222222222222222222222222222222000000000002221111111111111122000000000000-
0000000000000000000000000000000000000000000000000000000000000000000000022111111111112220000000000000-
0000000000000000000000000000000000000000000000000000000000000000000000002221111111122000000000000000-
0000000000000000000000000000000000000000000000000000000000000000000000000022222222220000000000000000-
0000000000000000000000000000000000000000000000000000000000000000000000000000000000000000000000000000-
0000000000000000000000000000000000000000000000000000000000000000000000000000000000000000000000000000-
0000000000000000000000000000000000000000000000000000000000000000000000000000000000000000000000000000-
0000000000000000000000000000000000000000000000000000000000000000000000000000000000000000000000000000-
0000000000000000000000000000000000000000000000000000000000000000000000000000000000000000000000000000-
0000000000000000000000000000000000000000000000000000000000000000000000000000000000000000000000000000-
0000000000000000000000000000000000000000000000000000000000000000000000000000000000000000000000000000-
0000000000000000000000000000000000000000000000000000000000000000000000000000000000000000000000000000-
0000000000000000000000000000000000000000000000000000000000000000000000000000000000000000000000000000-
0000000000000000000000000000000000000000000000000000000000000000000000000000000000000000000000000000-
0000000000000000000000000000000000000000000000000000000000000000000000000000000000000000000000000000-
0000000000000000000000000000000000000000000000000000000000000000000000000000000000000000000000000000-
0000000000000000000000000000000000000000000000000000000000000000000000000000000000000000000000000000-
--