11111111111111111111111111111111112000000000000000000000000211111111111111111111120000000021-
11111111111111111111111111111111112000000000000000000000000211111111111111111111120000000021-
11111111111111111111111111111111112000000000000000000000000211111111111111111111120000000021-
11111111111111111111111111111111112000000000000000000000000211111111111111111111120000000021-
11111111111111111111111111111111112000000000000000000000000211111111111111111111120000000021-
11111111111111111111111111111111112000000000000000000000000211111111111111111111120000000021-
11111111122222222222222222222222222000000000000000000000000222222222222222222222220000000021-
11111111120000000000000000222000000000000000000000000000000000000000000000000000000000000021-
11111111120000000000000000222000000000000000000000000000000000000000000000000000000000000021-
11111111120000002222000000222000000000000000000000000000000000000000000000000000000000000021-
11111111120000002112000000222000000000000000000000000000000000000000000000000000000000000021-
11111111120000002222000000222000000000000000000000000000000000000000000000000000000000000021-
11111111120000000000000000222000000000000000000000000000000000000000000000000000000000000021-
11111111120000000000000222222000000000000000000000000000000000000000000000000000000000000021-
11111111120000000000000222222000000000000000000000000000000000000000000000000000000000000021-
11111111120000000000000000000000000000000000000000000000000000000000000000000000000000000021-
11111111120000000000000000000000000000000000000000000000000000000000000000000000000000000021-
11111111120000000000000000000000000000000000000000000000000000022222222000000000000000000021-
11111111120000000000000000000000000000000000000000000000000000021111112000000000000000000021-
11111111120000000000000000000000000000000000000000000000000000021111112000000000000000000021-
11111111120000000000000000000000000000000000000000000000000000021111112000000000000000000021-
11111111120000000000000000000000000000000000000000000000000000021111112000000000000000000021-
11111111122222222222222222222000000000000000000000000000000000021111112000000000000000000021-
11111111122222222222222222222000000000000000000000000000000000021111112000000000000000000021-
11111111122222222222222222222000000000000000000000000000000000021111112000000000000000000021-
11111111120000000000000000000000000000000000000000000000000000021111112000000000000000000021-
11111111120000000000000000000000000000000000000000000000000000021111112000000000000000000021-
11111111120000000000000000000000000000000000000000000000000000022222222000000000000000000021-
11111111120000000000000000000000000000000000000000000000000000000000000000000000000000000021-
11111111120000000000000000000000000000000000000000000000000000000000000000000000000000000021-
11111111122222222222222222222000000000000000000000000000000000000000000000000000000000000021-
11111111120000000000000000000000000000000000000000000000000000000000000000000000000000000021-
11111111120000000000000000000000000000000000000000000000000000000000000000000000000000000021-
11111111120000000000000000000000000000000000000000000000000000000000000000000000000000000021-
11111111120000000000000000000000000000000000000000000000000000000000000000000000000000000021-
11111111120000000000000000000000000000000000000000000000000000000000000000000000000000000021-
11111111120000000000000000000000000000000000000000000000000000000000000000000000000000000021-
11111111120000000000000000000000000000000000000000000000000000000000000000000000000000000021-
11111111120000000000000000000000000000000000000000000000000000000000000000000000000000000021-
11111111120000000000000000000000000000000000000000000000000000000000000000000000000000000021-
11111111120000000000000000000000000000000000000000000000000000000000000000000000000000000021-
11111111120000000000000000000000000000000000000000000000000000000000000000000000000000000021-
11111111120000000000000000000000000000000000000000000000000000000000000000000000000000000021-
11111111122222222222222222222222222000000000000000000000000222222222222222222222220000000021-
11111111111111111111111111111111112000000000000000000000000211111111111111111111120000000021-
11111111111111111111111111111111112000000000000000000000000211111111111111111111120000000021-
11111111111111111111111111111111112000000000000000000000000211111111111111111111120000000021-
11111111111111111111111111111111112000000000000000000000000211111111111111111111120000000021-
11111111122222222222222222212222222000000000000000000000000222222222222222222222220000000021-
11111111120000000000000000212000000000000000000000000000000000000000000000000000000000000021-
11111111120000000000000000212000000000000000000000000000000000000000000000000000000000000021-
11111111120000002222000000212000000000000000000000000000000000000000000000000000000000000021-
11111111120000002112000000212000000000000000000000000000000000000000000000000000000000000021-
11111111120000002222000000212000000000000000000000000000000000000000000000000000000000000021-
11111111120000000000000000212000000000000000000000000000000000000000000000000000000000000021-
11111111120000000000000222222000000000000000000000000000000000000000000000000000000000000021-
11111111120000000000000000000000000000000000000000000000000000000000000000000000000000000021-
11111111120000000000000000000000000000000000000000000000000000000000000000000000000000000021-
11111111120000000000000000000000000000000000000000000000000000000000000000000000000000000021-
11111111120000000000000000000000000000000000000000000000000000000000000000000000000000000021-
11111111120000000000000000000000000000000000000000000000000000000000000000000000000000000021-
11111111120000000000000000000000000000000000000000000000000000022222222000000000000000000021-
11111111120000000000000000000000000000000000000000000000000000021111112000000000000000000021-
11111111120000000000000000000000000000000000000000000000000000021111112000000000000000000021-
11111111120000000000000000000000000000000000000000000000000000021111112000000000000000000021-
11111111120000000000000000000000000000000000000000000000000000021111112000000000000000000021-
11111111122222222222222222222000000000000000000000000000000000021111112000000000000000000021-
11111111111111111111111111112000000000000000000000000000000000021111112000000000000000000021-
11111111122222222222222222222000000000000000000000000000000000021111112000000000000000000021-
11111111120000000000000000000000000000000000000000000000000000021111112000000000000000000021-
11111111120000000000000000000000000000000000000000000000000000021111112000000000000000000021-
11111111120000000000000000000000000000000000000000000000000000022222222000000000000000000021-
11111111120000000000000000000000000000000000000000000000000000000000000000000000000000000021-
11111111120000000000000000000000000000000000000000000000000000000000000000000000000000000021-
11111111122222222222222222222000000000000000000000000000000000000000000000000000000000000021-
11111111120000000000000000000000000000000000000000000000000000000000000000000000000000000021-
11111111120000000000000000000000000000000000000000000000000000000000000000000000000000000021-
11111111120000000000000000000000000000000000000000000000000000000000000000000000000000000021-
11111111120000000000000000000000000000000000000000000000000000000000000000000000000000000021-
11111111120000000000000000000000000000000000000000000000000000000222222222200000000000000021-
11111111120000000000000000000000000000000000000000000000000000002111111111112000000000000021-
11111111120000000000002222222200000000000000000000000000000000002111111111112000000000000021-
11111111120000000000002111111200000000000000000000000000000000021111111111112000000000000021-
11111111120000000000002111111200000000000000000000000000000000021111111111112000000000000021-
11111111120000000000002111111200000000000000000000000000000000021111111111112000000000000021-
11111111120000000000002111111200000000000000000000000000000000002222222222220000000000000021-
11111111120000000000002111111200000000000000000000000000000000000000000000000000000000000021-
11111111122222222222222111111222222222222222222222222222222222222222222222222222222222222221-
11111111111111111111111111111111111111111111111111111111111111111111111111111111111111111111-
11111111111111111111111111111111111111111111111111111111111111111111111111111111111111111111-
--



