2222222222222222222222222222222222222222222222222222222222222222222222222222222222222222222222222222222222222-
1111111111111111111111111111111111111111111111111111111111111111111111111111111111111111111111111111111111111-
2222222222222222222222222222222222222222222222222222222222222222222222222222222222222222222222222222222222222-
1200000000000000000000000000000000002120000000000000000000000000000000000000000000000000000000000000000000000-
1200000000000000000000000000000000002120000000000000000000000000000000000000000000000000000000000000000000000-
1200000000000000000000000000000000002120000000000000000000000000000000000000000000000000000000000000000000000-
1200000000000000000000000000000000002120000000000000000000000000000000000000000000000000000000000000000000000-
1200000000000000000000000000000000002120000000000000000000000000000000000000000000000000000000000000000000000-
1200000000000000000000000000000000002120000000000000000000000000000000000000000000000000000000000000000000000-
1200000000000000000000000000000000002120000000000000000000000000000000000000000000000000000000000000000000000-
1200000000000000000000000000000000002120000000000000000000000000000000000000000000000000000000000000000000000-
1200000000000000000000000000000000002120000000000000000000000000000000000000000000000000000000000000000000000-
1200000000000000000000000000000000002120000000000000000000000000000000000000000000000000000000000000000000000-
1200000000000000000000000000000000002120000000000000000000000000000000000000000000000000000000000000000000000-
1200000000000000000000000000000000002120000000000000000000000000000000000000000000000000000000000000000000000-
1200000000000000000000000000000000002120000000000000000000000000000000000000000000000000000000000000000000000-
1222222222222200002222222222222222222122222222222222222222222200000022222222222222222222222222222222222222222-
1111111111111100001111111111111111112121111111111111111111111100000011111111111111111111111111111111111111111-
1222222222222200002222222222222222222122222222222222222222222200000022222222222222222222222222222222222222222-
1200000000000000000000000000000000002120000000000000000000000000000000000000000000000000000000000000000000000-
1200000000000000000000000000000000002120000000000000000000000000000000000000000000000000000000000000000000000-
1200000000000000000000000000000000002120000000000000000000000000000000000000000000000000000000000000000000000-
1200000000000000000000000000000000002120000000000000000000000000000000000000000000000000000000000000000000000-
1200000000000000000000000000000000002120000000000000000000000000000000000000000000000000000000000000000000000-
1200000000000000000000000000000000002120000000000000000000000000000000000000000000000000000000000000000000000-
1200000000000000000000000000000000002120000000000000000000000000000000000000000000000000000000000000000000000-
1200000000000000000000000000000000002120000000000000000000000000000000000000000000000000000000000000000000000-
1200000000000000000000000000000000002120000000000000000000000000000000000000000000000000000000000000000000000-
1200000000000000000000000000000000002120000000000000002222000000000000000000000000000000000000000000000000000-
1200002222222222000000000000000000000000000000000000021111200000000000000000000000000000000000000000000000000-
1200001111111111000000000000000000000000000000000000211111120000000000000000000000000000000000000000000000000-
1200002222222222000000000000000000002120000000000002111111120000000000000000000000000000000000000000000000000-
1200000000000000000000000000000000002120000000000000211111200000000000000000000000000000000000000000000000000-
1200000000000000000000000000000000002120000000000000022222000000000000000000000000000000000000000000000000000-
1200000000000000000000000000000000002120000000000000000000000000000000000000000000000000000000000000000000000-
1222222222222200002222222222222222222122222222222222222222222200000022222222222222222222222222222222222222222-
1111111111111100001111111111111111112121111111111111111111111100000011111111111111111111111111111111111111111-
1222222222222200002222222222222222222122222222222222222222222200000022222222222222222222222222222222222222222-
1200000000000000000000000000000000002120000000000000000000000000000000000000000000000000000000000000000000000-
1200000000000000000000000000000000002120000000000000000000000000000000000000000000000000000000000000000000000-
1200000000000000000000000000000000002120000000000000000000000000000000000000000000000000000000000000000000000-
1200000000000000000000000000000000002120000000000000000000000000000000000000000000000000000000000000000000000-
1200000000000000000000000000000000002120000000000000000000000000000000000000000000000000000000000000000000000-
1200000000000220000000000000000000002120000000000000000000000000000000000000000000000000000000000000000000000-
1200000000000220000000000000000000002120000000000000000000000000000000000000000000000000000000000000000000000-
1200000000000220000000000000000000002120000000000000000000022200000000000000000000000000000000000000000000000-
1200000000000220000000000000000000002120000000000000000000022200000000000000000000000000000000000000000000000-
1200000000000220000000000000000000002120000000000000000000022200000000000000000000000000000000000000000000000-
1200000000000220000000000000000000002120000000000000000000022200000000000000000000000000000000000000000000000-
1222222222222220000000000000000000002120000000000000000000022200000000000000000000000000000000000000000000000-
1200000000000000000000000000000000002120000000000000000000022200000000000000000000000000000000000000000000000-
1222222222222200002222222222222222222122222222222222222222222200000022222222222222222222222222222222222222222-
1111111111111100001111111111111111112121111111111111111111111100000011111111111111111111111111111111111111111-
1222222222222200002222222222222222222122222222222222222222222200000022222222222222222222222222222222222222222-
1200000000000000000000000000000000002120000000000000000000000000000000000000000000000000000000000000000000000-
1200000000000000000000000000000000002120000000000000000000000000000000000000000000000000000000000000000000000-
1200000000000000000000000000000000002120000000000000000000000000000000000000000000000000000000000000000000000-
1200000000000000000000000000000000002120000000000000000000000000000000000000000000000000000000000000000000000-
1200000000000000000000000000000000002120000000000000000000000000000000000000000000000000000000000000000000000-
1200000000000220000000000000000000002120000000000000000000000000000000000000000000000000000000000000000000000-
1200000000000220000000000000000000002120000000000000000000000000000000000000000000000000000000000000000000000-
1200000000000220000000000000000000002120000000000000000000022200000000000000000000000000000000000000000000000-
1200000000000220000000000000000000002120000000000000000000022200000000000000000000000000000000000000000000000-
1200000000000220000000000000000000002120000000000000000000022200000000000000000000000000000000000000000000000-
1200000000000220000000000000000000002120000000000000000000022200000000000000000000000000000000000000000000000-
1222222222222220000000000000000000002120000000000000000000022200000000000000000000000000000000000000000000000-
1200000000000000000000000000000000002120000000000000000000022200000000000000000000000000000000000000000000000-
1222222222222200002222222222222222222122222222222222222222222200000022222222222222222222222222222222222222222-
1111111111111100001111111111111111112121111111111111111111111100000011111111111111111111111111111111111111111-
1222222222222200002222222222222222222122222222222222222222222200000022222222222222222222222222222222222222222-
1200000000000000000000000000000000002120000000000000000000000000000000000000000000000000000000000000000000000-
1200000000000000000000000000000000002120000000000000000000000000000000000000000000000000000000000000000000000-
1200000000000000000000000000000000002120000000000000000000000000000000000000000000000000000000000000000000000-
1200000000000000000000000000000000002120000000000000000000000000000000000000000000000000000000000000000000000-
1200000000000000000000000000000000002120000000000000000000000000000000000000000000000000000000000000000000000-
1200000000000000000000000000000000002120000000000000000000000000000000000000000000000000000000000000000000000-
1200000000000000000000000000000000002120000000000000000000000000000000000000000000000000000000000000000000000-
1200000000000000000000000000000000002120000000000000000000000000000000000000000000000000000000000000000000000-
1200000000000000000000000000000000002120000000000000000000000000000000000000000000000000000000000000000000000-
1200000000000000000000000000000000002120000000000000002222000000000000000000000000000000000000000000000000000-
1200002222222222000000000000000000000000000000000000021111200000000000000000000000000000000000000000000000000-
1200001111111111000000000000000000000000000000000000211111120000000000000000000000000000000000000000000000000-
1200002222222222000000000000000000002120000000000002111111120000000000000000000000000000000000000000000000000-
1200000000000000000000000000000000002120000000000000211111200000000000000000000000000000000000000000000000000-
1200000000000000000000000000000000002120000000000000022222000000000000000000000000000000000000000000000000000-
1200000000000000000000000000000000002120000000000000000000000000000000000000000000000000000000000000000000000-
1222222222222200002222222222222222222122222222222222222222222200000022222222222222222222222222222222222222222-
1111111111111100001111111111111111112121111111111111111111111100000011111111111111111111111111111111111111111-
1222222222222200002222222222222222222122222222222222222222222200000022222222222222222222222222222222222222222-
1200000000000000000000000000000000002120000000000000000000000000000000000000000000000000000000000000000000000-
1200000000000000000000000000000000002120000000000000000000000000000000000000000000000000000000000000000000000-
1200000000000000000000000000000000002120000000000000000000000000000000000000000000000000000000000000000000000-
1200000000000000000000000000000000002120000000000000000000000000000000000000000000000000000000000000000000000-
1200000000000000000000000000000000002120000000000000000000000000000000000000000000000000000000000000000000000-
1200000000000220000000000000000000002120000000000000000000000000000000000000000000000000000000000000000000000-
1200000000000220000000000000000000002120000000000000000000000000000000000000000000000000000000000000000000000-
1200000000000220000000000000000000002120000000000000000000022200000000000000000000000000000000000000000000000-
1200000000000220000000000000000000002120000000000000000000022200000000000000000000000000000000000000000000000-
1200000000000220000000000000000000002120000000000000000000022200000000000000000000000000000000000000000000000-
1200000000000220000000000000000000002120000000000000000000022200000000000000000000000000000000000000000000000-
1222222222222220000000000000000000002120000000000000000000022200000000000000000000000000000000000000000000000-
1200000000000000000000000000000000002120000000000000000000022200000000000000000000000000000000000000000000000-
1200000000000000000000000000000000002120000000000000000000000000000000000000000000000000000000000000000000000-
1200000000000000000000000000000000002120000000000000000000000000000000000000000000000000000000000000000000000-
2222222222222222222222222222222222222222222222222222222222222222222222222222222222222222222222222222222222222-
1111111111111111111111111111111111111111111111111111111111111111111111111111111111111111111111111111111111111-
2222222222222222222222222222222222222222222222222222222222222222222222222222222222222222222222222222222222222-
--
